30 30
1 1
##############################
#....#.....#...#.......#.....#
####..####...#.#..#.##.#.###.#
#...#.#..#####..#.#..#.#...#.#
##.##.............##.#..##.#.#
##...#.##.....###...###.##.#.#
#..#.#..#.....#...#.#...##.#.#
#.##..#.#.....###.##..#..#..##
#.#.#...#.....#....#.#..##..##
#.#.#####.....##.#.....#...###
#.#.....#.....##..####...#...#
#.###..##.....###...##..#.##.#
#...##..#.....#.###.##.##..#.#
###.###.#.......###.##...#...#
#.#.#.........##....##..#.####
#...#.###.....##.##...#.#..#.#
##.##.#.#.....##....##..##...#
##..#...#.....#.###.##.##..#.#
#.#.#.###.....#.#.#.##.#..####
#.#.##..#.....#...#..#...#...#
#.....#.#.....#.##.#..#.#..#.#
#.##.#..#.....#....##.###.##.#
#...#..########..##.#.....##.#
###.............#....##.##.#.#
#..#.###########..##..#.##...#
##...##........#...##.#...####
#.#.###.####.###.##...########
#...#...#......#.##.###......#
###...#..#..##...##.....####.#
##############################