40 30
2 1
########################################
##..........####...#####....####....####
##.#####.....##.............#...####...#
#..#####..##.###...####.....####....####
####....##...#######....###......###...#
#......#....####....##......####.%..####
####....####....##......####....####...#
#...####....###.....####....####....####
#....#........#...............#........#
#....#......####..............##....####
#.####........#.................##.....#
##..........####..............##....####
#.............#.................##.....#
#...........####..............##....####
#.............#.................##.....#
#...........####..............##....####
#.............#.................##.....#
#...........####................#...####
#.##..........#.######..##########.....#
#.######....####....................####
#.##............#...............####...#
#.######....####....................####
#.##............................####...#
#.######....####...#..##....####....####
#.##...................................#
#.######....####...#..##....####....####
#.##.....###....####....####....####...#
#.######....####...#..##....####....####
#........###....####............####...#
########################################