11 5
1 3
###########
#%.########
##..#######
#..########
###########