40 30
14 2
########################################
####........####....####....####....####
########....................#...####...#
#...####...#####....###.....####....####
####....##......####....###.....####...#
#...........####....##......####.%..####
####....####....##......####....####...#
#...####....###.....####....####....####
#.............#........................#
#...........####..............##....####
#.............#.................##.....#
#...........####..............##....####
#.............#.................##.....#
#...........####..............##....####
#.............#.................##.....#
#...........####..............##....####
#.............#.................##.....#
#...........####................#...####
#.##..........#.######..##########.....#
#.######....####....................####
#.##............#...............####...#
#.######....####....................####
#.##............................####...#
#.######....####...#..##....####....####
#.##...................................#
#.######....####...#..##....####....####
#.##.....###....####....####....####...#
#.######....####...#..##....####....####
#........###....####............####...#
########################################