40 30
6 9
########################################
#####...%...####....####....####....####
########....................#...####...#
#...####...#####....###.....####....####
####....##......####....###.....####...#
#...........####....##......####....####
####....####....##......####....####...#
#...####....###.....####....####....####
#.............#........................#
#...........####..............##....####
#.............#.................##.....#
#...........####..............##....####
#.............#.................##.....#
#...........####..............##....####
#.............#.................##.....#
#...........####..............##....####
#.............#.................##.....#
#...........####................#...####
#.##..........#.######..##########.....#
#.######....####....................####
#.##............#...............####...#
#.######....####....................####
#.##............................####...#
#.######....####...#..##....####....####
#.##...................................#
#.######....####...#..##....####....####
#.##.....###....####....####....####...#
#.######....####...#..##....####....####
#........###....####............####...#
########################################