40 30
3 5
########################################
#####.......####....####....####....####
########....................#...####...#
#...####...#####....###.....####....####
####............####....###.....####...#
###.....#...####....##......####....####
####....####....##......####....####...#
#.%.####....###.....####....####....####
#.............#........................#
#...........####..............##....####
#.............#.................##.....#
#...........####..............##....####
#.............#.................##.....#
#...........####..............##....####
#.............#.................##.....#
#...........####..............##....####
#.............#.................##.....#
#...........####................#...####
#.##..........#.######..##########.....#
#.######....####....................####
#.##............#...............####...#
#.######....####....................####
#.##............................####...#
#.######....####...#..##....####....####
#.##...................................#
#.######....####...#..##....####....####
#.##.....###....####....####....####...#
#.######....####...#..##....####....####
#........###....####............####...#
########################################